2 2 4 3 5 2 2 2 2 2 2 2 2 2 2 2
2 2 4 3 5 0 0 0 0 0 0 0 0 0 0 2
2 2 4 3 5 0 0 0 0 0 0 0 0 0 0 2
2 2 4 3 5 0 0 0 0 0 0 0 0 0 0 2
2 2 4 3 5 0 0 0 0 0 0 0 0 0 0 2
2 2 4 3 3 6 6 6 6 6 6 6 6 6 6 2
2 2 4 3 3 3 3 3 3 3 3 3 3 3 5 2
2 2 4 3 3 7 7 7 7 3 3 3 7 7 7 2
2 2 4 3 5 2 2 2 2 4 3 5 2 2 2 2
2 2 4 3 5 2 2 2 2 4 3 5 2 2 2 2
2 2 4 8 5 2 2 2 2 4 8 5 2 2 2 2
2 2 2 2 2 2 2 2 2 2 2 2 2 2 2 2